Venusaurite - Starboard City
Charizardite X - Stark Rangiroa
Charizardite Y - Route 5-1
Blastoisinite - Route 12
Alakazite - Route 2
Gengarite - Cemetery
Kanghaskhanite - Route 17
Gyaradosite - Psyco Rangiroa
Pinsirite - Route 15
Aerodactylite - Otomai Island
Scizorite - Mystery Lake
Absolite - Route 10
Garchompite - Route 6
Lucarionite - Frigost Cave
Slowbronite - Route 12
Sableyenilite - route 3
Sharpedonite - Route 14
Salamencite - Brakmar Chamber
Metagrossite - Luris Cave
Loppunite - Route 18
Galladite - Limia's Port
Pidgeotite - Route 19
Gardevoirite - Fear Rangiroa
Swampertite - Otomai Forest
Glalitite - Snow Hill 
Beedrilite - Treech Forest
Steelixtite - Route 11
Sceptilite - Route5 Quest
Blazikenite - Otomai Vulcan
Cameruptite - Nubious Desert
Altarianite - Límia City House
Latiasite - Southern Island
Latiosite - Southern Island
Diancite - Mystic Labiryth
Heacrossnite - Abaco machinne
Medichanite - Abaco Machinne
Houdoonite - Abaco Machinne
Manectite - Power Plant
Tyranitarnite - Mystic Mountain Cave
Banetite - Hero Cemetery
Mewtwonite X - Beta Tower
Mewtwonite Y - Beta Tower
Abomasite - Snow Hill Cave
Ampharosite - Hidrelétrica
Mawilite - Old Mine
Aggorinite - Cave Route 3